R  1920 1080
NO ./path_to_the_north_texture
SO ./path_to_the_south_texture
WE ./path_to_the_west_texture
EA ./path_to_the_east_texture

S ./path_to_the_sprite_texture
F 220,100,35
C 225,30,16

111111111111111111111111111111
1000000000110000000001001
1011000000011100002000N01
1001000000010000000000001
111111111011110001110000000000001
100000000011000001110111111111111
11110111111111011100000010001
11111111111111011101010010001
11000000110101011100000010001
10000000000000001100000010001
10000000000000001101010010001
110000011101010111110111100111
10000000001111000000000000001
11100000000000000000000000000
11111111011111110111111111111