R  1920 1080
NO ./texture/glass.png
SO ./pics/colorstone.png
WE ./pics/greystone.png
EA ./pics/purplestone.png

S ./path_to_the_sprite_texture
F 220,100,35
C 255,0,0

111111111111111111111111111111
1000000000110000000001001
1001000000011100000000001
1001000000010000000000001
1111110000111100011100001
11000000110101011100000011111
10000000000000001100000010001
10000000000000001101010010001
100000011101010011010100100011
10000000001111000000000000001
11100000000000N00000000000001
11111111111111111111111111111