R 1920 1080
NO ./textures/txt/mur_neon.xpm
SO ./textures/txt/mur_neon.xpm
WE ./textures/txt/mur_neon.xpm
EA ./textures/txt/mur_neon.xpm
S ./textures/txt/crystal_0.xpm
F 255,0,0
C 0,255,0


1111111111111111
1000000000000011
1000000000000011
10N0000000000011
1000000000000011
1000000200000011
1000000000000011
1000000000011111
1000000000000011
1111111100000011
1000000000000011
1000000000000011
1000000000000011
1111111111111111

